SNV = "countries/Soviet Navy.txt"
NUD = "countries/Northumberland.txt"
CMX = "countries/Couto Misto.txt"
GSH = "countries/Kagoshima.txt"
OKI = "countries/Okinawa.txt"
MIY = "countries/Miyazaki.txt"
KUM = "countries/Kumamoto.txt"
OIT = "countries/Oita.txt"
FKK = "countries/Fukuoka.txt"
SAG = "countries/Saga.txt"
NAS = "countries/Nagasaki.txt"
EHI = "countries/Ehime.txt"
KGW = "countries/Kagawa.txt"
TOK = "countries/Tokushima.txt"
KOC = "countries/Kochi.txt"
YAM = "countries/Yamaguchi.txt"
SHI = "countries/Shimane.txt"
TOT = "countries/Tottori.txt"
HIR = "countries/Hiroshima.txt"
ANI = "countries/Andaman and Nicobar Islands.txt"
AJR = "countries/Ajmer.txt"
CRG = "countries/Coorg.txt"
DLH = "countries/Delhi.txt"
PTH = "countries/Panth Piploda.txt"
OKA = "countries/Okayama.txt"
HYO = "countries/Hyogo.txt"
KYO = "countries/Kyoto.txt"
KYC = "countries/Kyoto City.txt"
WAK = "countries/Wakayama.txt"
NAR = "countries/Nara.txt"
MIE = "countries/Mie.txt"
SIG = "countries/Shiga.txt"
OSA = "countries/Osaka.txt"
GIF = "countries/Gifu.txt"
YMN = "countries/Yamanashi.txt"
SKA = "countries/Shizuoka.txt"
TOY = "countries/Toyama.txt"
ISI = "countries/Ishikawa.txt"
FKU = "countries/Fukui.txt"
NGO = "countries/Nagano.txt"
AIC = "countries/Aichi.txt"
TKY = "countries/Tokyo.txt"
CBA = "countries/Chiba.txt"
ANA = "countries/Kanagawa.txt"
TCG = "countries/Tochigi.txt"
SAI = "countries/Saitama.txt"
IBA = "countries/Ibaraki.txt"
NII = "countries/Niigata.txt"
GUN = "countries/Gunma.txt"
YMG = "countries/Yamagata.txt"
MYG = "countries/Miyagi.txt"
FKS = "countries/Fukushima.txt"
IWT = "countries/Iwate.txt"
AKI = "countries/Akita.txt"
AOM = "countries/Aomori.txt"
HOK = "countries/Hokkaido.txt"
MAT = "countries/Mount Athos.txt"
LMS = "countries/Mustang.txt"
KRF = "countries/Karafuto.txt"
AGC = "countries/Aguascalientes.txt"
AGS = "countries/Alagoas.txt"
AMP = "countries/Amapa.txt"
ANC = "countries/Anarchy.txt"
ANW = "countries/Anhwei.txt"
ARL = "countries/Ardalan.txt"
ASY = "countries/Assyria.txt"
BCS = "countries/Baja California Sur.txt"
BDT = "countries/Bandits.txt"
BFD = "countries/Brazillian Federal District.txt"
BHA = "countries/Bahia.txt"
BIH = "countries/Bihar.txt"
BIY = "countries/Bialystok.txt"
CAU = "countries/Coahuila.txt"
CIL = "countries/Chihli.txt"
CKC = "countries/Coke.txt"
CKG = "countries/Chekiang.txt"
CKI = "countries/Cook Islands.txt"
CLC = "countries/South California.txt"
CLM = "countries/Colima.txt"
CPC = "countries/Campeche.txt"
CRA = "countries/Ceara.txt"
CST = "countries/Castile.txt"
CUU = "countries/Chihuahua.txt"
DGC = "countries/Diego Garcia.txt"
DRG = "countries/Durango.txt"
ESS = "countries/Espirito Santo.txt"
ETC = "countries/East Turcomania.txt"
EXD = "countries/Extremadura.txt"
FAS = "countries/Fars.txt"
FCK = "countries/City of Krakow.txt"
FUK = "countries/Fukien.txt"
GJR = "countries/Guanajuato.txt"
GLN = "countries/Gilan.txt"
GOI = "countries/Goias.txt"
GRR = "countries/Guerrero.txt"
HDL = "countries/Hidalgo.txt"
HNN = "countries/Hunan.txt"
HOA = "countries/Honan.txt"
HPH = "countries/Hupeh.txt"
IGC = "countries/Igauacu.txt"
JLS = "countries/Jalisco.txt"
KGS = "countries/Kiangsu.txt"
KHO = "countries/Khorasan.txt"
KIE = "countries/Kielce.txt"
KNG = "countries/Kiangsi.txt"
KRM = "countries/Kerman.txt"
KWC = "countries/Kweichow.txt"
LAR = "countries/Larestan.txt"
LBL = "countries/Lublin.txt"
LDZ = "countries/Lodz.txt"
LKT = "countries/Lokot.txt"
LMC = "countries/La Mancha.txt"
LRS = "countries/Lorestan.txt"
LWO = "countries/Lwow.txt"
MAH = "countries/Maharashtra.txt"
MDD = "countries/Madrid.txt"
MDP = "countries/Madhya Pradesh.txt"
MGS = "countries/Mato Grosso do Sul.txt"
MHB = "countries/Mahabad.txt"
MHC = "countries/Michoacan.txt"
MLV = "countries/Moldavia.txt"
MRG = "countries/Minas Gerais.txt"
MRH = "countries/Maranhao.txt"
MRL = "countries/Morelos.txt"
MSV = "countries/Masovia.txt"
MTG = "countries/Mato Grosso.txt"
MXC = "countries/Mexico City.txt"
MXS = "countries/Mexico State.txt"
MZD = "countries/Mazandaran.txt"
NFI = "countries/Norfolk Island.txt"
NIU = "countries/Niue.txt"
NNK = "countries/Nanking.txt"
NOM = "countries/Nomads.txt"
NOW = "countries/Nowogrodek.txt"
NLE = "countries/Nuevo Leon.txt"
NYR = "countries/Nayarit.txt"
ORI = "countries/Odisha.txt"
OXC = "countries/Oaxaca.txt"
PBL = "countries/Puebla.txt"
PEP = "countries/Pepsi.txt"
PKG = "countries/Peking.txt"
PNB = "countries/Pernambuco.txt"
PRA = "countries/Para.txt"
PRB = "countries/Paraiba.txt"
PR2 = "countries/Parana.txt"
PSC = "countries/Provisional Republic of China.txt"
PSE = "countries/Polesie.txt"
PSH = "countries/Pashtunistan.txt"
PUI = "countries/Piaui.txt"
QTA = "countries/Queretaro.txt"
QTR = "countries/Quintana Roo.txt"
RDJ = "countries/Rio de Janeiro.txt"
RDN = "countries/Rondonia.txt"
RFC = "countries/Reformed Republic of China.txt"
RGC = "countries/Reorganised Republic of China.txt"
RGN = "countries/Rio Grande do Norte.txt"
RSI = "countries/Italian Social Republic.txt"
ROR = "countries/Roraima.txt"
SAZ = "countries/South Azerbaijan.txt"
SEP = "countries/Sergipe.txt"
SGE = "countries/South Georgia.txt"
SLD = "countries/Sealand.txt"
SLP = "countries/San Luis Potosi.txt"
SNL = "countries/Sinaloa.txt"
SPU = "countries/Sao Paulo.txt"
STW = "countries/Stanislawow.txt"
SVA = "countries/Slavonia.txt"
SXE = "countries/Saxe-Eisenach.txt"
TAP = "countries/Tarnopol.txt"
TBR = "countries/Tabarestan.txt"
TBS = "countries/Tabasco.txt"
TCT = "countries/Tocartins.txt"
TKL = "countries/Union Islands.txt"
TML = "countries/Tamil Nadu.txt"
TMU = "countries/Tamaulipas.txt"
TNT = "countries/Tientstin.txt"
TRB = "countries/Tribes.txt"
TRM = "countries/Tarim.txt"
TXC = "countries/Tlaxcala.txt"
UTT = "countries/Uttar Pradesh.txt"
VGR = "countries/Volga Germany.txt"
VLH = "countries/Volhynia.txt"
VRC = "countries/Veracruz.txt"
WLN = "countries/Wilno.txt"
WRS = "countries/City of Warsaw.txt"
WST = "countries/Wasteland.txt"
WSW = "countries/Warsaw.txt"
WTC = "countries/West Turcomania.txt"
ZCT = "countries/Zacatecas.txt"
ZGH = "countries/Jungaria.txt"
SCH = "countries/Schleswig.txt"
HLS = "countries/Holstein.txt"
LCH = "countries/Lake Chad.txt"
LCN = "countries/Lake Congo.txt"
KGG = "countries/Kel Ahaggar.txt"
IMO = "countries/Oman.txt"
TNA = "countries/Turkana.txt"
KPY = "countries/Komi-Permyak.txt"
YKT = "countries/Yakutsk.txt"
MRE = "countries/Mari El.txt"
MRD = "countries/Mordovia.txt"
TTR = "countries/Tatarstan.txt"
CCI = "countries/Chukchi.txt"
KYK = "countries/Koryak.txt"
ABM = "countries/Aga Buryat-Mongol.txt"
BML = "countries/Buryat-Mongolia.txt"
KKS = "countries/Khakassia.txt"
KTM = "countries/Khanty-Mansi.txt"
TMY = "countries/Taymyr.txt"
EVK = "countries/Evenk.txt"
VMO = "countries/Vitim-Olekminsk.txt"
UBM = "countries/Ust Orda Buryat-Mongolia.txt"
UDM = "countries/Udmurtia.txt"
CVS = "countries/Chuvashia.txt"
YMM = "countries/Yanomami.txt"
CNL = "countries/Cinta Larga.txt"
RLP = "countries/Rheinland-Pfalz.txt"
BDW = "countries/Baden-Württemberg.txt"
SAA = "countries/Sachsen-Anhalt.txt"
HSN = "countries/Hessen.txt"
MBV = "countries/Mecklenburg-Vorpommern.txt"
NSA = "countries/Niedersachsen.txt"
NRW = "countries/Nordrhein-Westfalen.txt"
BWH = "countries/Bhawhal.txt"
CH2 = "countries/Cherra.txt"
DWR = "countries/Dwara.txt"
JRN = "countries/Jirang.txt"
KYM = "countries/Khryim.txt"
LAG = "countries/Langrin.txt"
LNG = "countries/Langiong.txt"
MHM = "countries/Maharam.txt"
MSO = "countries/Malai Sohmat.txt"
MRW = "countries/Marriw.txt"
MWD = "countries/Mawdon.txt"
MWN = "countries/Mawiang.txt"
MWL = "countries/Mawlong.txt"
MPL = "countries/Mawphlang.txt"
MYL = "countries/Mylliem.txt"
NBP = "countries/Nobosohphoh.txt"
NLW = "countries/Nonglwai.txt"
NKH = "countries/Nongkhlaw.txt"
NNS = "countries/Nongspung.txt"
NST = "countries/Nongstoin.txt"
PAG = "countries/Pamsanngut.txt"
RBR = "countries/Rambrai.txt"
SLL = "countries/Shella.txt"
SOG = "countries/Sohiong.txt"
MWR = "countries/Mawsynram.txt"
ILY = "countries/Illyria.txt"
TSR = "countries/Transamur.txt"
ERU = "countries/Eastern Rumelia.txt"
RUM = "countries/Rumelia.txt"
KUK = "countries/Kapitaï und Koba.txt"
GFB = "countries/Groß Friedrichsburg.txt"
MHL = "countries/Mahinland.txt"
DWI = "countries/Deutsch-Witu.txt"
KHS = "countries/Kohistan.txt"
HZR = "countries/Hazara.txt"
KYB = "countries/Khyber.txt"
KRR = "countries/Kurram.txt"
TCH = "countries/Tochi.txt"
WAA = "countries/Wana.txt"
NGL = "countries/Naga.txt"
NFT = "countries/Northeast Frontier Tracts.txt"
DDS = "countries/Davenport Downs Station.txt"
ATT = "countries/Attica.txt"
CGR = "countries/Central Grece.txt"
CMC = "countries/Central Macedonia.txt"
EMC = "countries/Eastern Macedonia and Thrace.txt"
NAN = "countries/North Agean.txt"
PPN = "countries/Pelopponese.txt"
SGN = "countries/South Agean.txt"
THS = "countries/Thessaly.txt"
WGC = "countries/Western Greece.txt"
WMC = "countries/Western Macedonia.txt"
TEK = "countries/Teke.txt"
PET = "countries/Petoria.txt"
KNS = "countries/Khangsar.txt"
DEE = "countries/Dergean.txt"
LNT = "countries/Lingtsang.txt"
NGH = "countries/Nangchan.txt"
MAZ = "countries/Mazur.txt"
DNG = "countries/Drango.txt"
CBR = "countries/Beri.txt"
TRH = "countries/Trehor.txt"
GKS = "countries/Goloks.txt"
YSH = "countries/Yushu Tribes.txt"
NGW = "countries/Ngawa.txt"
SUO = "countries/Suomo.txt"
SMD = "countries/Shimdrok.txt"
DGB = "countries/Dangba.txt"
ZHJ = "countries/Zhuokeji.txt"
SGG = "countries/Songgang.txt"
CHS = "countries/Chuosi.txt"
NGG = "countries/Ninglang.txt"
CKL = "countries/Chakla.txt"
CHN = "countries/Choni.txt"
LKE = "countries/Lake Eyre.txt"
QTT = "countries/Qattara Depression.txt"
CED = "countries/Chott el Djerid.txt"
LDF = "countries/Lake Darfur.txt"
LKS = "countries/Lake Senegal.txt"
LKF = "countries/Lake Fezzan.txt"
MCD = "countries/McDonalds.txt"
BYB = "countries/Byzantine Beylik.txt"
LSA = "countries/South African Lakes.txt"
LKM = "countries/Lake Maghreb.txt"
LKB = "countries/Lake Makgadikgadi.txt"
NQS = "countries/North Queensland.txt"
MGN = "countries/Magnitogorsk.txt"